#############################################
##..T..#.....#..P..#.....#..P..#.....#..T..##
#S.###...###...###...###...###...###...###..#
##.....#..M..#.....#..E..#.....#..M..#.....##
#############################################