#####################
##..T..#.....#..P..##
#S.###...###...###.E#
##.....#..M..#.....##
#####################