T......T......E
.######.######.
.#P....P....M#.
.#.####.####.#.
.#.#...M...#.#.
.#.#.##.##.#.#.
.#.#.#...#.#.#.
T.P.M..M..M.T.P
.#.#.#...#.#.#.
.#.#.##.##.#.#.
.#.#...M...#.#.
.#.####.####.#.
.#M....T....T#.
.######.######.
S......P......P