T......T.T....T
.######.######.
T#M....M..M.M#T
.#.####.####.#.
T#M#P..P..P#M#.
.#.#.##.##.#.#.
T#M#P#...#P#.#.
..M.P..E..P.M.T
.#.#.#...#.#.#.
S#.#.##.##P#M#.
.#.#....P.P#.#T
.#.####.####.#.
.#......M..MM#T
.######T######.
...........T..T