T...T..T...T
.#####.####.
.#M.M...M.#T
T#.###.##.#.
.#M#.P.P#M#.
T#M#P..P#.#.
.....E...M.T
S#.#.P.P#.#.
.#.###.##.#.
.#.....M.M#T
.#####T####.
.......T..T.