#P..T..M#
####.###P
####.###.
####.###.
E...S...M
####.###.
####.###.
####.###T
#T..P..M#