#E##E##E####
#.##.##.####
#.##.##.####
#P..T..M####
####.###P..E
####.###.###
####.###.###
E...S...M..E
####.###.###
####.###.###
####.###P..E
#T..P..M####
#.##.##.####
#.##.##.####
#E##E##E####